14 12
WWWWWWWWWWWW
www..T...www
WWW.WWWWW.WW
WwW..T....WW
WWW..WW..WWW
WWWW.WWW.WWW
WTWW.WWW.WWW
WWW..WWW.WWW
WWW.WW.W..WW
WWW..WWW..WW
WWW.wWWW..WW
W.W.WWWM.WWW
W.WWWW...wwW
WWWWwWWWWWWW