14 12
WWWWWWWWWWWW
WWWTTTWWWTTW
WWW.WWWWW.WW
WwW.......WW
WWW..WW..WWW
WWWW.WWW.WWW	
WWWW.WWW.WWW
WWW..WWW.WWW
WWW.WW.W..WW
WWW..WWW..WW
WTW.wWWW..TW
W.W.WWWMWWWW
W.TTWW.W.wwW
WWWWwWWWWWWW